%%%%%%%%%%%%%%%%%%%%
%o...%........%...A%
%.%%.%.%%%%%%.%.%%.%
%.%..............%.%
%.%.%%.%%  %%.%%.%.%
%......%G  G%......%
%.%.%%.%%%%%%.%%.%.%
%.%..............%.%
%.%%.%.%%%%%%.%.%%.%
%A...%...P....%...o%
%%%%%%%%%%%%%%%%%%%%
