%%%%%%%%%%%%%%%%%%%%
%o...%........%...T%
%.%%.%.%%%%%%.%.%%.%
%.%..............%.%
%.%.%%.%%  %%.%%.%.%
%......%G  G%......%
%.%.%%.%%%%%%.%%.%.%
%.%..............%.%
%.%%.%.%%%%%%.%.%%.%
%T...%...P....%...o%
%%%%%%%%%%%%%%%%%%%%
